.,.,.,.,.,.,.,.,.,.,.,.,.,.,.,.,.,.,.,.
.,.,.,.,.,.,.,.,.,.,.,.,.,.,.,.,.,.,.,.
.,.,.,.,.,.,.,.,.,.,.,.,.,.,.,.,.,.,.,.
.,.,.,.,.,.,.,.,.,.,.,.,.,.,.,.,.,.,.,.
.,.,.,.,.,.,.,.,.,.,.,.,.,.,.,.,.,.,.,.
.,.,.,.,.,.,.,.,.,.,.,.,.,.,.,.,.,.,.,.
.,.,.,.,.,.,.,.,.,.,.,.,.,.,.,.,.,.,.,.
.,.,.,.,.,.,.,.,.,.,.,.,.,.,.,.,.,.,.,.
.,.,.,.,.,.,.,.,.,.,.,.,.,.,.,.,.,.,.,.
.,.,.,.,.,.,.,.,.,.,.,.,.,.,.,.,.,.,.,.
.,.,.,.,.,.,.,.,.,.,.,.,.,.,.,.,.,.,.,.
.,.,.,.,.,.,.,.,.,.,.,.,.,.,.,.,.,.,.,.
.,.,.,.,.,.,y,.,.,.,.,.,.,.,.,.,.,.,.,.
.,.,.,.,.,x,b,.,r,.,.,.,.,.,.,.,.,.,.,.
.,.,.,.,.,x,x,.,r,r,.,.,.,.,.,.,.,.,.,.
.,.,.,x,x,x,x,.,.,.,.,.,.,.,.,.,.,.,.,.
.,.,.,.,.,.,.,.,.,.,x,x,.,.,.,.,.,.,.,.
.,.,x,x,x,.,.,.,.,.,x,x,.,.,.,.,.,.,.,.
.,x,x,x,x,.,.,x,x,.,x,x,x,.,.,.,.,.,.,.
.,x,x,x,x,.,.,x,x,.,x,x,x,.,.,.,.,.,.,.