x,.,.,.,.,.,.,.,.,.,.,.,.,.,.,.,.,.,.,.
.,.,.,.,.,.,.,.,.,.,.,.,.,.,.,.,.,.,.,.
.,.,.,.,.,.,.,.,.,.,.,.,.,.,.,.,.,.,.,.
.,.,.,.,.,.,.,.,.,.,.,.,.,.,.,.,.,.,.,.
.,.,.,.,.,.,.,.,.,.,.,.,.,.,.,.,.,.,.,.
.,.,.,.,.,.,.,.,.,.,.,.,.,.,.,.,.,.,.,.
.,.,.,.,.,.,.,.,.,.,.,.,.,.,.,.,.,.,.,.
.,.,.,.,.,.,.,.,.,.,.,.,.,.,.,.,.,.,.,.
.,.,.,.,.,.,.,.,.,.,.,.,.,.,.,.,.,.,.,.
.,.,.,.,.,.,.,.,.,.,.,.,.,.,.,.,.,.,.,.
.,.,.,.,.,.,.,.,.,.,.,.,.,.,.,.,.,.,.,.
.,.,.,.,.,.,.,.,.,.,.,.,.,.,.,.,.,.,.,.
.,.,.,.,.,.,x,.,.,.,.,.,.,.,.,.,.,.,.,.
.,.,.,.,.,x,x,.,r,.,.,.,.,.,.,.,.,.,.,.
.,.,.,.,.,x,x,.,.,.,.,.,.,.,.,.,.,.,.,.
.,.,.,x,x,x,x,.,.,.,.,.,.,.,.,.,.,.,.,.
.,.,.,.,.,.,.,.,.,.,x,x,.,.,.,.,.,.,.,.
.,.,x,x,x,.,.,.,.,.,x,x,.,.,.,.,.,.,.,.
.,x,x,x,x,.,.,x,x,.,x,x,.,.,.,.,.,.,.,.
.,x,x,x,x,.,.,x,x,.,x,x,.,.,.,.,.,.,.,.
